11
8
22 19 17 17 17 17 17 17 17 18 22
22 04 00 00 00 00 00 00 00 03 22
22 04 00 00 00 00 00 00 00 03 22
22 04 00 00 00 00 00 00 00 03 22
22 04 00 00 00 00 00 00 00 03 22
22 04 00 00 00 00 00 00 00 03 22
22 04 00 00 00 00 00 00 00 03 22
05 21 21 21 21 21 21 21 21 21 06