24
8
22 22 22 22 22 22 22 22 22 22 22 22 22 22 22 22 22 22 22 22 22 22 22 22
22 22 19 17 17 17 17 17 17 17 17 17 17 17 17 17 17 17 17 17 17 18 22 22
22 22 04 00 00 00 00 00 00 00 00 00 00 00 00 00 00 00 00 00 00 03 22 22
22 22 04 00 00 00 00 00 00 00 00 00 00 00 00 00 00 00 00 00 00 03 22 22
22 22 04 00 00 00 00 00 00 00 00 00 00 00 00 00 00 00 00 00 00 03 22 22
22 22 04 00 00 00 00 00 00 00 00 01 21 21 21 21 02 00 00 00 00 03 22 22
22 22 04 00 00 00 00 00 00 01 21 21 06 22 22 05 21 21 21 21 21 21 06 22
22 05 21 21 21 21 21 21 21 21 06 22 22 22 22 22 22 22 22 22 22 22 22 22